VL1_galspn	galspn
VL2_galspn	galspn
EW1_galeld	galeld
EW2_galeld	galeld
AM1_galano	galano
AM2_galano	galano
BZ1_galbreaus	galbreaus
BZ2_galbreaus	galbreaus
BZ3_galbreaus	galbreaus
NB1_galspn	galspn
NB2_galspn	galspn
BC1_galbrenz	galbrenz
AS1_galano	galano
AS2_galano	galano
GM1_galgol	galgol
GM2_galgol	galgol
DD1_galspd	galspd
DD2_galspd	galspd
BD1_galbrenz	galbrenz
BD2_galbrenz	galbrenz
GR1_galgol	galgol
GR2_galgol	galgol
GC1_galgol	galgol
GC2_galgol	galgol
BT1_galbrenz	galbrenz
BT2_galbrenz	galbrenz
DW2_galspd	galspd
DW1_galspd	galspd
NM1_galspn	galspn
NM2_galspn	galspn
BM1_galbrenz	galbrenz
BM2_galbrenz	galbrenz
FA1_galdep	galdep
FA2_galdep	galdep
BR1_galbrenz	galbrenz
BR2_galbrenz	galbrenz
XF1_galspz	galspz
XH1_galspz	galspz
XH2_galspz	galspz
DU1_galspd	galspd
DU2_galspd	galspd
TO1_galtev	galtev
TO2_galtev	galtev
PV1_galpul	galpul
PV2_galpul	galpul
BY1_galbreaus	galbreaus
BX1_galbreaus	galbreaus
BX2_galbreaus	galbreaus
TL1_galtev	galtev
TV2_galtev	galtev
TT1_galtev	galtev
TT2_galtev	galtev
DS2_galspd	galspd
DS1_galspd	galspd
AP1_galano	galano
AP2_galano	galano
DH1_galtev	galtev
DH2_galtev	galtev
DN1_galtev	galtev
DN2_galtev	galtev
VW2_galvul	galvul
VW1_galvul	galvul
PR1_galpul	galpul
PT1_galpul	galpul
EP1_galeld	galeld
EP2_galeld	galeld
EI1_galeld	galeld
EI2_galeld	galeld
PP1_galpul	galpul
PT2_galpul	galpul
FS1_galdep	galdep
FS2_galdep	galdep
EM1_galeld	galeld
EM2_galeld	galeld
VJ1_galvul	galvul
VJ2_galvul	galvul
FB1_galdep	galdep
FB2_galdep	galdep
NA1_galspn	galspn
NA2_galspn	galspn
NW2_galspn	galspn
NW1_galspn	galspn
XO1_galspz	galspz
XO2_galspz	galspz
DV2_galspd	galspd
DV1_galspd	galspd
DC1_galspd	galspd
DC2_galspd	galspd
SM1_galsps	galsps
SM2_galsps	galsps
SA1_galsps	galsps
SA2_galsps	galsps
SV1_galsps	galsps
SV2_galsps	galsps
DO1_galspd	galspd
DO2_galspd	galspd
DR1_galspd	galspd
DR2_galspd	galspd
FM1_galdep	galdep
FM2_galdep	galdep
GV1_galgol	galgol
GV2_galgol	galgol
XA1_galspz	galspz
XA2_galspz	galspz
GW1_galgol	galgol
GW2_galgol	galgol
XB1_galspz	galspz
XB2_galspz	galspz
DK1_galspd	galspd
DK2_galspd	galspd
XL1_galspz	galspz
XL2_galspz	galspz
ET1_galeld	galeld
ET2_galeld	galeld
GP1_galgol	galgol
GP2_galgol	galgol
XI1_galspz	galspz
XI2_galspz	galspz
BO1_galbrenz	galbrenz
BO2_galbrenz	galbrenz
IA1_galnev	galnev
IA2_galnev	galnev
IB1_galnev	galnev
IB2_galnev	galnev
IC1_galnev	galnev
IC2_galnev	galnev
ID2_galnev	galnev
ID1_galnev	galnev
IE1_galnev	galnev
IE2_galnev	galnev
IF1_galnev	galnev
IF2_galnev	galnev
IG1_galnev	galnev
IG2_galnev	galnev
XG1_galspz	galspz
XG2_galspz	galspz
PB1_galpul	galpul
PB2_galpul	galpul
AM3_galano	galano
VL3_galspn	galspn
FC2_galdep	galdep
FC1_galdep	galdep
NC1_galspn	galspn
NC2_galspn	galspn
AD1_galano	galano
AD2_galano	galano
PK1_galpul	galpul
PK2_galpul	galpul
VM1_galvul	galvul
VM2_galvul	galvul
AH1_galano	galano
AH2_galano	galano
AH3_galano	galano
AH4_galano	galano
AT1_galano	galano
VT1_galvul	galvul
AM4_galano	galano
DM1_galspd	galspd
AM5_galano	galano
PG1_galpul	galpul
PG2_galpul	galpul
XU1_galspz	galspz
DL1_galspd	galspd
XD1_galspz	galspz
DA1_galspd	galspd
XC1_galspz	galspz
XE1_galspz	galspz
XK1_galspz	galspz
XK2_galspz	galspz
XR1_galspz	galspz
XT1_galspz	galspz
TV1_galtev	galtev
DB1_galspd	galspd
DB2_galspd	galspd
SW1_galsps	galsps
SW2_galsps	galsps
PW1_galpul	galpul
PO1_galpul	galpul
PO2_galpul	galpul
PU1_galpul	galpul
PU2_galpul	galpul
DT1_galspd	galspd
DT2_galspd	galspd
XW1_galspz	galspz
XW2_galspz	galspz
DP1_galspd	galspd
DP2_galspd	galspd
